﹁	「
﹂	」
﹃	﹁
﹄	﹂
伲	你
倮	裸
凇	淞
処	處
凼	幽
剳	劄
勛	勳
勦	剿
哌	呱
嗬	呵
嚮	向
囯	國
坂	阪
墒	墑
奬	獎
寀	采
尜	嘎
崐	崑
嵛	崳
巌	巖
幷	並
彔	录
彚	彙
捜	搜
擀	搟
暸	瞭
朮	術
桔	橘
榘	矩
槼	規
歎	嘆
氽	汆
沲	沱
浜	濱
溼	濕
炤	照
煅	鍛
獃	呆
珉	玟
珏	玨
琯	管
産	產
畲	畬
皰	疱
眎	視
礡	礴
禰	祢
稭	秸
紥	紮
綫	線
罎	罈
肀	聿
脩	修
葯	藥
蔴	麻
蝰	虺
蟮	蟺
証	證
贜	贓
躰	體
郃	合
郄	隙
鈡	鐘
鉆	鑽
銼	剉
鋻	鑑
錘	鎚
録	錄
鑒	鑑
閑	閒
閧	鬨
靣	面
騃	呆
鶏	雞
鷄	雞
！象	！像
‘	『
’	』
“	「
”	」
「恩！	「嗯！
「当！	「噹！
「当」	「噹」
0海里	0海里
０海里	０海里
0里	0里
０里	０里
1海里	1海里
１海里	１海里
1里	1里
１里	１里
2海里	2海里
２海里	２海里
2里	2里
２里	２里
3海里	3海里
３海里	３海里
3里	3里
３里	３里
4海里	4海里
４海里	４海里
4里	4里
４里	４里
5海里	5海里
５海里	５海里
5里	5里
５里	５里
6海里	6海里
６海里	６海里
6里	6里
６里	６里
7海里	7海里
７海里	７海里
7里	7里
７里	７里
8海里	8海里
８海里	８海里
8里	8里
８里	８里
9海里	9海里
９海里	９海里
9里	9里
９里	９里
一干就	一幹就
一斗不	一鬥不
一出剧院	一出劇院
一只只	一隻隻
一海里	一海里
七海里	七海里
九海里	九海里
二海里	二海里
人象	人像
八海里	八海里
十海里	十海里
又干又	又乾又
又松	又鬆
又象	又像
三海里	三海里
上冲洗	上沖洗
也象	也像
千海里	千海里
口干一	口幹一
口干什	口幹什
口干那	口幹那
口干活	口幹活
口干员	口幹員
口干掉	口幹掉
口干这	口幹這
口干着	口幹著
子姜	子薑
山涯	山崖
已松	已鬆
已松下	已鬆下
已象	已像
已象征服	已像征服
已象征战	已像征戰
已经象	已經像
干肉贩	幹肉販
干似	乾似
干的好	幹的好
干疤	乾疤
干面前	乾面前
干孙	乾孫
干掉杯	乾掉杯
干货物	幹貨物
干窘	乾窘
干阳	乾陽
干尽一壶	乾盡一壺
干涧	乾澗
干坛	乾罈
干搁	乾擱
干瞪	乾瞪
干声	乾聲
才干了杯	才乾了杯
才干干净	才乾乾淨
才干那杯	才乾那杯
才干枯	才乾枯
才干耗	才乾耗
才干脆	才乾脆
才干涸	才乾涸
才干净	才乾淨
才干爽	才乾爽
才干这杯	才乾這杯
才干着急	才乾著急
才不干枯	才不乾枯
才不干涸	才不乾涸
才不干燥	才不乾燥
才象	才像
不修篇幅	不修邊幅
不象	不像
五海里	五海里
仍象	仍像
内函	內涵
六海里	六海里
分象	分像
升泰	昇泰
反朴归真	反璞歸真
天佑	天祐
太象	太像
尤如	猶如
尤带	猶帶
尤疑	猶疑
尤怜	猶憐
尤豫	猶豫
心系统	心系統
手表示	手表示
手表现	手表現
手表达	手表達
手表态	手表態
手表演	手表演
扎彩	紮彩
扎着	紮著
扎稳	紮穩
支签	支籤
斗的过	鬥的過
斗擞	抖擻
木纳	木訥
火拼	火拚
他白干	他白幹
他象	他像
他象征战	他像征戰
令媛	令嬡
包函	包涵
包卷	包捲
北游	北遊
半海里	半海里
去干一杯	去乾一杯
去干了杯	去乾了杯
去干洗	去乾洗
去干耗	去乾耗
去干净	去乾淨
去干着急	去乾著急
去卷	去捲
可以象	可以像
可象	可像
可象征战	可像征戰
古法自制	古法自製
叼扰	叨擾
叼难	刁難
只大老鼠	隻大老鼠
只牛	隻牛
只犬	隻犬
只巨兽	隻巨獸
只母老虎	隻母老虎
只羊	隻羊
只老狐狸	隻老狐狸
只老虎	隻老虎
只老鼠	隻老鼠
只兔	隻兔
只怪物	隻怪物
只怪兽	隻怪獸
只招子	隻招子
只狗	隻狗
只狐狸	隻狐狸
只虎	隻虎
只狼	隻狼
只畜生	隻畜生
只马	隻馬
只鬼	隻鬼
只猛兽	隻猛獸
只蛋	隻蛋
只野兽	隻野獸
只鸟	隻鳥
只鹿	隻鹿
只猴	隻猴
只狮	隻獅
只凤	隻鳳
只猪	隻豬
只猫	隻貓
只鸡	隻雞
只骡	隻騾
只驴	隻驢
四海里	四海里
它象	它像
必游	必遊
必须品	必需品
戊戍	戊戌
戊卫	戍衛
打不准	打不準
未松下	未鬆下
未愈	未癒
正象	正像
玉佩	玉珮
生克	生剋
白白干	白白幹
白淅	白皙
白澈	白皙
目定口呆	目瞪口呆
石象	石像
石膏象	石膏像
仿徉	彷徉
仿效	倣傚
全象	全像
共制	共製
共御	共禦
再卷	再捲
再象	再像
同仇敌慨	同仇敵愾
吊系	吊繫
吊念	弔念
吊信	弔信
吊贺	弔賀
吊钱	弔錢
吐干	吐乾
合并且	合並且
吃茶	喫茶
回光反照	迴光反照
地卷	地捲
多出电影	多齣電影
奸拐	姦拐
好象	好像
她象	她像
如坐针毯	如坐針氈
宅弟	宅第
宅紫	奼紫
弛骋	馳騁
曲薛	麴薛
朱喻	硃喻
朱矶	硃磯
百海里	百海里
竹框	竹筐
竹荀	竹筍
竹杆	竹竿
而象	而像
舟揖	舟楫
衣驱	衣袪
西装毕挺	西裝筆挺
佛象	佛像
估不准	估不準
伺奉	侍奉
伸卷	伸捲
作崇	作祟
你白干	你白幹
你象	你像
低迥	低迴
伶敏	靈敏
余海里	餘海里
克苦	刻苦
克剜	剋剜
即象	即像
君子好求	君子好逑
告侥	告饒
吹卷	吹捲
吹须	吹鬚
吮干	吮乾
夹衣	裌衣
夹袄	裌襖
彷佛	彷彿
快卷	快捲
我白干	我白幹
我象	我像
抉别	訣別
扼塞	阨塞
折卷	折捲
扮象	扮像
更象	更像
决择	抉擇
汨没	汩沒
没白干	沒白幹
没辄	沒轍
灸热	炙熱
狂卷	狂捲
系引	係引
系手	繫手
系乎	繫乎
系妥	繫妥
系起	繫起
系挂	繫掛
系绊	繫絆
系块	繫塊
系脚	繫腳
肖象	肖像
谷麦	穀麥
谷稻	穀稻
豆鼓	豆豉
身系	身繫
巡戈	巡弋
防碍	妨礙
劭雍	邵雍
并砌	併砌
并图	併圖
并赃	併贓
事干脆	事乾脆
事干净	事乾淨
些象	些像
函洞	涵洞
函容	涵容
函意	涵意
函煦	涵煦
函义	涵義
函管	涵管
函蓄	涵蓄
函盖	涵蓋
函养	涵養
函濡	涵濡
函蕴	涵蘊
刻象	刻像
刻象征服	刻像征服
刮胡须	刮鬍鬚
制丹	製丹
制器	製器
卒草	捽草
卒悉	窣窸
卒发	捽髮
卓约风姿	綽約風姿
卷出	捲出
卷伏	捲伏
卷向	捲向
卷好	捲好
卷至	捲至
卷伴	捲伴
卷身	捲身
卷往	捲往
卷拂	捲拂
卷卧	捲臥
卷飞	捲飛
卷个	捲個
卷射	捲射
卷得	捲得
卷扫	捲掃
卷涌	捲湧
卷碎	捲碎
卷罩	捲罩
卷滚	捲滾
卷舞	捲舞
卷裹	捲裹
卷荡	捲蕩
卷袭	捲襲
取谛	取締
呷干	呷乾
呼卷	呼捲
周息	週息
坦护	袒護
姑负	辜負
岳立	嶽立
岳峙	嶽峙
店铺	店舖
弦管	絃管
彼彼皆是	比比皆是
忽松	忽鬆
念一声	唸一聲
所扎	所紮
所卷	所捲
抿灭	泯滅
抹台	抹檯
抹刹	抹煞
抽佣	抽佣
拙壮	茁壯
抵砺	砥礪
抬扛	抬摃
易斗的	易鬥的
昏瞑	昏暝
松化	鬆化
松去	鬆去
松甩	鬆甩
松肘	鬆肘
松泛	鬆泛
松肩	鬆肩
松骨	鬆骨
松筋	鬆筋
松闲	鬆閒
松腰	鬆腰
松齿	鬆齒
松绳	鬆繩
注：	註：
泥象	泥像
沾污	玷汙
沾辱	玷辱
治疔	治療
物志	物誌
的亮发	的亮髮
直卷	直捲
直发抖	直發抖
罔罔	惘惘
罔然	惘然
虎咽	虎嚥
初斗然	初陡然
初愈	初癒
金象奖	金像獎
长台	長檯
长发布	長發布
长象	長像
陀手	舵手
陀表	陀錶
阿腴	阿諛
青笞	青苔
青棵	青稞
非常象	非常像
非象	非像
非象征服	非像征服
囹围	囹圉
信缄	信箋
便松	便鬆
便象	便像
剌刀	刺刀
则象	則像
则象征服	則像征服
则象征战	則像征戰
却象	卻像
咽一口	嚥一口
咽入	嚥入
咽口水	嚥口水
咽不下	嚥不下
咽回	嚥回
咽食	嚥食
咽得下	嚥得下
咽嚼	嚥嚼
型状	形狀
奕棋	弈棋
姜油	薑油
姜花	薑花
姜愈老	薑愈老
姜葱	薑蔥
姜醋	薑醋
姣洁	皎潔
很象	很像
急卷	急捲
恰象	恰像
挖松	挖鬆
拼一拼	拚一拚
拼上一拼	拚上一拚
拼个	拚個
既象	既像
映象	映像
是白干	是白幹
柔发	柔髮
流卷	流捲
活象	活像
抵犊情深	舐犢情深
玲胧	玲瓏
甚松	甚鬆
相形见拙	相形見絀
相象	相像
看不准	看不準
看出电影	看齣電影
砌并	砌併
竽头	芋頭
背系	背繫
胡鬓	鬍鬢
茅芦	茅廬
英寸	英吋
衫毕挺	衫筆挺
要冲凉	要沖涼
迥廊	迴廊
迥避	迴避
迨尽	殆盡
面线	麵線
面馍	麵饃
面摊牌	面攤牌
面摊开	面攤開
音不准	音不準
风姿卓约	風姿綽約
眈误	耽誤
倒卷	倒捲
倒象	倒像
俱象	俱像
个象	個像
准以为	準以為
哪象	哪像
娉亭	娉婷
射不准	射不準
席子	蓆子
座象	座像
徒峭	陡峭
径自	逕自
径取	逕取
径庭	逕庭
径砸	逕砸
径寄	逕寄
径启	逕啟
径答	逕答
恭逢	躬逢
捂不住	摀不住
捂住	摀住
捉只	捉隻
捉狭	促狹
挺而	鋌而
挺象	挺像
挽近	輓近
效尤	傚尤
效法	傚法
旁徨	徬徨
旁惶	徬徨
株象	株像
栓住	拴住
殷勤	慇勤
气慨	氣概
浪卷	浪捲
海函	海涵
疾卷	疾捲
盍盍	溘溘
盍逝	溘逝
盍然	溘然
盍谢	溘謝
眩耀	炫耀
真知卓见	真知灼見
真象	真像
真缔	真諦
神只	神祇
神佑	神祐
神祗	神祇
神象	神像
租贷	租賃
笆蕉	芭蕉
笑容可鞠	笑容可掬
笑讷	笑納
笑魇	笑靨
纯系	純係
耗干	耗乾
能干休	能干休
能干政	能干政
能干笑	能乾笑
能干嚎	能乾嚎
能干搁	能乾擱
能干瞪	能乾瞪
能象	能像
荆朴	荊璞
茶干掉	荼乾掉
茶干尽	茶乾盡
起来象	起來像
躬敬	恭敬
轫性	韌性
迷罔	迷惘
迷朦	迷濛
回然	迥然
回响当	迴響當
追朔	追溯
追根究抵	追根究柢
闪铄	閃爍
陡松	陡鬆
只鹰	隻鷹
马僵	馬韁
高干脆	高乾脆
捋胡	捋鬍
畛怀	軫懷
做到象	做到像
偶象	偶像
倏松	倏鬆
兜卷	兜捲
勘乱	戡亂
商铺	商舖
婀挪	婀娜
寂聊	寂寥
康愈	康癒
强干杯	強乾杯
强干涉	強干涉
强干脆	強乾脆
强干预	強干預
强干扰	強干擾
强御	強禦
彩杖	綵杖
彩牌	綵牌
彩裳	綵裳
得象	得像
徜若	倘若
凄息	棲息
凄戚	悽慼
戚嗟	慼嗟
戚忧	慼憂
戚颜	慼顏
掘松	掘鬆
扫卷	掃捲
挣松	掙鬆
排泄	排泄
掀卷	掀捲
捻手	撚手
教悔	教誨
斛斗	觔斗
旋卷	旋捲
旋涡	漩渦
梗直	鯁直
清淅	清晰
混肴	混淆
淬厉	淬礪
犁牛	犛牛
猛卷	猛捲
琅嬛	瑯嬛
瓷制	瓷製
略松	略鬆
畦径	畦逕
眼困	眼睏
眼框	眼眶
累累	纍纍
羞赦	羞赧
舶船	泊船
船浆	船槳
船蓬	船篷
船纤	船縴
莫明其妙	莫名其妙
被卷	被捲
通谍	通牒
通辑	通緝
连抉	連袂
造象	造像
郭朴	郭璞
都象	都像
钓游	釣遊
竟象	竟像
顶顶大名	鼎鼎大名
劳骚	牢騷
喧染	渲染
喝三坛	喝三罈
喝两坛	喝兩罈
喉干	喉乾
孱杂	羼雜
寒仓	寒傖
寒喧	寒暄
就象	就像
嵇首	稽首
帽璎	帽纓
几乎象	幾乎像
几海里	幾海里
复亡	覆亡
复叠	覆疊
徨恐	惶恐
悲泯	悲憫
揩台	揩檯
揉躏	蹂躪
挥卷	揮捲
摒息	屏息
敢再干杯	敢再乾杯
敢松	敢鬆
斑烂	斑斕
棵象	棵像
钦崎	嶔崎
游兵	遊兵
游巡	遊巡
游狎	遊狎
游军	遊軍
游唱	遊唱
游蜂	遊蜂
游豫	遊豫
涌卷	湧捲
浑函	渾涵
然无幸	然無倖
然象	然像
琢制	琢製
画象	畫像
番薯	蕃薯
痉孪	痙攣
发皓	髮皓
发髯	髮髯
硬拼	硬拚
稍松	稍鬆
等侯	等候
笋况	荀況
丝制	絲製
评击	抨擊
象一	像一
象二	像二
象人	像人
象三	像三
象已	像已
象之前	像之前
象什	像什
象今	像今
象水	像水
象片	像片
象以往	像以往
象以前	像以前
象他	像他
象它	像它
象平时	像平時
象永	像永
象在	像在
象她	像她
象有	像有
象自己	像自己
象似	像似
象你	像你
象我	像我
象那	像那
象些	像些
象两	像兩
象往	像往
象所有	像所有
象雨	像雨
象是	像是
象昨	像昨
象甚	像甚
象要	像要
象风	像風
象个	像個
象刚	像剛
象鬼	像鬼
象带	像帶
象您	像您
象现	像現
象这	像這
象吗	像嗎
象极	像極
象当	像當
象话	像話
象过去	像過去
象梦	像夢
象疯	像瘋
象银	像銀
象样	像樣
象谁	像誰
象赞	像贊
越象	越像
开铺	開舖
闲遐	閒暇
闲静	閑靜
雇有	僱有
雇舟	僱舟
雇车	僱車
雇马	僱馬
雇船	僱船
雇请	僱請
云：	云：
云宵	雲霄
须求	需求
须鬓	鬚鬢
饨面	飩麵
饮三坛	飲三罈
饮而干	飲而乾
饮两坛	飲兩罈
喑哑	瘖啞
蛩音	跫音
轸域	畛域
倾刻	頃刻
倾复	傾覆
汇萃	薈萃
圆椎	圓錐
塑象	塑像
微松	微鬆
微须	微鬚
意兴阑姗	意興闌珊
想干笑	想乾笑
想干脆	想乾脆
想干净	想乾淨
愈合心	愈合心
愈合乎	愈合乎
愈合他	愈合他
愈合用	愈合用
愈合式	愈合式
愈合作	愈合作
愈合我	愈合我
愈合身	愈合身
愈合拍	愈合拍
愈合理	愈合理
愈合意	愈合意
愈合适	愈合適
愈合拢	愈合攏
愈卷	愈捲
愈象	愈像
会象	會像
榔头	鎯頭
极待救	亟待救
极待解	亟待解
极象	極像
极极	亟亟
毁谤	譭謗
溶炉	熔爐
溜达	溜躂
烟没	湮沒
照象	照像
猷豫	猶豫
当然罗！	當然囉！
碗干	碗乾
碗素面	碗素麵
禁若寒蝉	噤若寒蟬
万只怕	萬只怕
经斗数	經鬥數
经白干	經白幹
罩卷	罩捲
群象	群像
圣象	聖像
肆业	肄業
腮胡	腮鬍
装璜	裝潢
里面冲身	裡面沖身
里象	裡像
袅雄	梟雄
解象	解像
解签	解籤
该象	該像
跟跄	踉蹌
较象	較像
农获	農穫
运筹惟幄	運籌帷幄
逼奸	逼姦
遐疵	瑕疵
窣悉	窣窸
侥悻	僥倖
喽罗	嘍囉
图象	圖像
实象	實像
屡仆	屢仆
旗幡	旗旛
暝目	瞑目
榴连	榴槤
歉咎	歉疚
滚卷	滾捲
算不准	算不準
紧扎	緊紮
紧卷	緊捲
绸密	稠密
舔干	舔乾
舞卷	舞捲
蒙蒙胧	朦朦朧
蒙瞀	矇瞀
蒙瞢	矇瞢
蒙瞽	矇瞽
说签	說籤
轻挑	輕佻
轻篾	輕蔑
铜象	銅像
衔土	啣土
衔泥	啣泥
衔草	啣草
衔环	啣環
颇象	頗像
魁悟	魁梧
魂游	魂遊
僵绳	韁繩
凛列	凜洌
唠叼	嘮叨
嘴干	嘴乾
坠胎	墮胎
娇揉造作	矯揉造作
幡间	墦間
厮斗然	廝陡然
影象	影像
憔瘁	憔悴
扑卷	撲捲
撬松	撬鬆
数海里	數海里
暴卷	暴捲
枢钮	樞紐
潦阔	遼闊
潮卷	潮捲
熨干	熨乾
璀灿	璀璨
盘卷	盤捲
瞌然长逝	溘然長逝
确系着	確繫著
稽康	嵇康
稻杆	稻稈
箱函	箱涵
编篡	編纂
缈茫	渺茫
胶制	膠製
诸候	諸侯
谁干脆	誰乾脆
践道	棧道
铺位	舖位
震松	震鬆
髯发	髯髮
儆效	儆傚
憋脚	蹩腳
坛酒	罈酒
坛醋	罈醋
强界	疆界
懈迨	懈怠
挞虏	韃虜
朴玉	璞玉
横卷	橫捲
机抒	機杼
独游	獨遊
遗象	遺像
遗撼	遺憾
录象	錄像
锦镖	錦標
锱衣	緇衣
雕象	雕像
雕落	彫落
腼典	靦腆
颈系	頸繫
头扎	頭紮
头亮发	頭亮髮
头发出	頭發出
头发生	頭發生
头发呆	頭發呆
头发狂	頭發狂
头发育	頭發育
头发现	頭發現
头发麻	頭發麻
颓圯	頹圮
肴撰	餚饌
骼膊	胳膊
壑然	豁然
弥散	瀰散
徽菌	黴菌
应象	應像
戏彩	戲綵
擢足	濯足
滥芋充数	濫竽充數
烩干	燴乾
环佩	環珮
璨烂	燦爛
篾箪	篾簟
篷松	篷鬆
糟塌	糟蹋
糟达	蹧躂
糟遢	糟蹋
膺品	贗品
亵读	褻瀆
豁壑	谿壑
购并不	購並不
购并且	購並且
还象	還像
还象征服	還像征服
邂怠	懈怠
襁保	襁褓
归究	歸咎
归依佛门	皈依佛門
归依我佛	皈依我佛
归里	歸里
归朴	歸璞
箫条	蕭條
绣象	繡像
觞子	殤子
丰谀	豐腴
蹒顸	顢頇
转戾点	轉捩點
转寰	轉圜
锁碎	瑣碎
双并	雙併
啮齿	囓齒
拢断	壟斷
疆弩之末	彊弩之末
签卜	籤卜
签文	籤文
签爪	籤爪
罗唆	囉唆
罗哩	囉哩
罗嗦	囉嗦
罗里罗苏	囉哩囉囌
罗罗苏苏	囉囉囌囌
罗难	罹難
罗苏	囉囌
药制	藥製
蟹螫	蟹螯
邋塌	邋遢
邋蹋	邋遢
醮墨	蘸墨
铲去	剷去
铲灭	剷滅
难斗的	難鬥的
籍口	藉口
纂位	篡位
蕴函	蘊涵
蕴酿	醞釀
褴缕	襤褸
警剔	警惕
骚首弄姿	搔首弄姿
摄服	懾服
摄象	攝像
缠卷	纏捲
蜡象	蠟像
响当	響噹
飙卷	飆捲
听不准	聽不準
鞑伐	撻伐
颤斗	顫抖
挛生	孿生
显象	顯像
惊螫	驚蟄
羁拌	羈絆
谶悔	懺悔
灵俐	伶俐
骤松	驟鬆
鬓须	鬢鬚
箩卜	蘿蔔
蛮干净	蠻乾淨
蛮干燥	蠻乾燥
镶制	鑲製
镶崁	鑲嵌
代码	程式碼
任务栏	工作列
位图	點陣圖
信号	訊號
优先级	優先順序
光标	游標
光盘	光碟
光驱	光碟機
内存	記憶體
内置	內建
刻录	燒錄
创建	建立
加载	載入
卸载	解除安裝
图标	圖示
在线	線上
多任务	多工
多态	多型
字体	字型
密钥	金鑰
对话框	對話方塊
导入	匯入
卷积	摺積
扫描仪	掃描器
文档	文件
枚举	列舉
模块	模組
状态栏	狀態列
用户	使用者
异步	非同步
粘贴	貼上
绑定	繫結
网上邻居	網路上的芳鄰
网关	閘道器
编程	程式設計
缩进	縮排
声卡	音效卡
脱机	離線
脚本	指令碼
虚拟机	虛擬機器
视图	檢視
视频	視訊
设备	裝置
设置	設定
调用	呼叫
调试器	偵錯程式
远程	遠端
队列	佇列
集群	叢集
显卡	顯示卡
显存	視訊記憶體
点击	點選